6
0 0 2 1 4 
1 0 3 4 0 
1 1 3 2 2 
3 3 2 0 2 
1 1 3 4 3 
2 0 0 1 4 