2
0 4 3 2 2
1 2 2 2 1
1 2 2 2 2
0 3 1 1 3
3 2 0 2 0
2 4 2 2 0