3
1 1 1 1 1
4 2 3 1 2
2 1 4 1 2
3 0 1 3 0
2 1 0 4 3
0 3 2 3 1