4
3 1 4 3 4 
3 4 0 3 3 
1 4 1 2 1 
2 1 1 1 1 
1 0 4 4 4 
1 0 2 4 1 