3
2 1 1 1 0 
2 3 0 0 0 
2 0 1 0 3 
0 1 2 3 0 
2 0 2 3 1 
1 1 2 4 0