5
2 1 4 2 4 
2 2 2 2 0 
2 1 4 0 1 
3 4 2 4 2 
4 1 2 4 0 
3 1 3 2 1 