5
3 4 0 1 0 
4 2 2 0 1 
2 1 0 3 2 
0 2 0 2 0 
3 2 4 1 3 
2 0 3 1 4 