4
3 2 2 0 4 
0 2 4 0 2 
4 1 0 3 1 
1 1 3 2 2 
4 4 1 0 2 
0 2 3 0 3 