3
2 2 3 0 4 
3 4 3 2 2 
3 0 1 0 4 
1 4 2 1 3 
0 2 1 1 3 
3 3 1 3 3 