4
2 2 3 1 2 
0 1 2 1 0 
3 4 3 1 0 
3 2 2 3 2 
0 2 4 1 1 
3 1 1 0 2